"filename", "language", "C#", "comment", "blank", "total"
"d:\printing\universal-ui\scripts\callback.script", "C#", 12, 8, 1, 21
"d:\printing\universal-ui\scripts\connect.script", "C#", 113, 34, 7, 154
"d:\printing\universal-ui\scripts\console.script", "C#", 5, 2, 1, 8
"d:\printing\universal-ui\scripts\controlBar.script", "C#", 107, 19, 12, 138
"d:\printing\universal-ui\scripts\doCallback.script", "C#", 8, 1, 1, 10
"d:\printing\universal-ui\scripts\error.script", "C#", 1, 1, 1, 3
"d:\printing\universal-ui\scripts\idexMode.script", "C#", 56, 22, 8, 86
"d:\printing\universal-ui\scripts\keypad.script", "C#", 8, 4, 3, 15
"d:\printing\universal-ui\scripts\levelBed.script", "C#", 76, 12, 13, 101
"d:\printing\universal-ui\scripts\loadFilament.script", "C#", 92, 22, 10, 124
"d:\printing\universal-ui\scripts\main.script", "C#", 63, 17, 7, 87
"d:\printing\universal-ui\scripts\move.script", "C#", 156, 42, 18, 216
"d:\printing\universal-ui\scripts\pagePreInitialize.script", "C#", 13, 9, 2, 24
"d:\printing\universal-ui\scripts\parsing\parseCallback.script", "C#", 7, 4, 0, 11
"d:\printing\universal-ui\scripts\parsing\parseCommon.script", "C#", 74, 21, 8, 103
"d:\printing\universal-ui\scripts\parsing\parseFirmware.script", "C#", 12, 3, 1, 16
"d:\printing\universal-ui\scripts\parsing\parsePosition.script", "C#", 12, 2, 2, 16
"d:\printing\universal-ui\scripts\parsing\parsePrintSettings.script", "C#", 18, 53, 8, 79
"d:\printing\universal-ui\scripts\parsing\parseSDPrint.script", "C#", 48, 7, 6, 61
"d:\printing\universal-ui\scripts\parsing\parseSettings.script", "C#", 44, 13, 7, 64
"d:\printing\universal-ui\scripts\parsing\parseTemp.script", "C#", 24, 10, 4, 38
"d:\printing\universal-ui\scripts\parsing\parser.script", "C#", 20, 15, 1, 36
"d:\printing\universal-ui\scripts\pidTune.script", "C#", 127, 16, 12, 155
"d:\printing\universal-ui\scripts\preheat.script", "C#", 160, 29, 22, 211
"d:\printing\universal-ui\scripts\print.script", "C#", 142, 22, 6, 170
"d:\printing\universal-ui\scripts\printSettings.script", "C#", 156, 30, 10, 196
"d:\printing\universal-ui\scripts\printerCommands.script", "C#", 102, 57, 20, 179
"d:\printing\universal-ui\scripts\program.script", "C#", 12, 1, 1, 14
"d:\printing\universal-ui\scripts\read.script", "C#", 40, 5, 0, 45
"d:\printing\universal-ui\scripts\run.script", "C#", 4, 4, 0, 8
"d:\printing\universal-ui\scripts\sdPrint.script", "C#", 215, 37, 17, 269
"d:\printing\universal-ui\scripts\send.script", "C#", 57, 11, 1, 69
"d:\printing\universal-ui\scripts\settings.script", "C#", 96, 25, 15, 136
"d:\printing\universal-ui\scripts\shutdown.script", "C#", 27, 3, 4, 34
"d:\printing\universal-ui\scripts\swapExtruder.script", "C#", 29, 11, 2, 42
"d:\printing\universal-ui\scripts\tools.script", "C#", 10, 12, 2, 24
"d:\printing\universal-ui\scripts\updateLines.script", "C#", 16, 1, 2, 19
"Total", "-", 2162, 585, 235, 2982